12 22
1111111111111111111111
1000030000000300000001
1000000000222220000001
1000022222000000030001
1003000022023200200001
1200030000000222220001
1222220000300000300221
1002200022000022220001
1220000033000000330001
1000333300003300022001
1000033000300020330001
1111114444444441111111


5 5
1 1 1 1 1
1 0 0 0 1
1 0 0 0 1
1 0 0 0 1
1 1 1 1 1

