12 22
1111111111111111111111
1000030020000000000001
1777777770000030003001
1000000070077703000301
1003000703000000000301
1000207030003003203001
1030070307730700030301
1007700000037030305001
1307073030077770030001
1050077703007730300301
1000777000500000300301
1111114444444441111111


5 5
1 1 1 1 1
1 0 0 0 1
1 0 0 0 1
1 0 0 0 1
1 1 1 1 1

