12 22
1111111111111111111111
1774003600572003240001
1976045048803568804671
1347068336903794044861
1404329583560740925071
1664004024302250996801
1826978907595007202371
1008782770707457236401
1352620477085878000761
1840957454683670085371
1642664864085297530491
1111111111111111111111
