12 22
1111111111111111111111
1586290556405392482631
1780908328807628007001
1923283065729732506031
1326689030393503669381
1625090783820575737801
1826600670258002579001
1635630889974953594261
1927989820560052346961
1870050546546333405421
1595342846364293885071
1111111111111111111111
