12 22
1111111111111111111111
1000000000070000000001
1000000000070200700001
1000000300077777700001
1003003000070003000034
1000050030070000000054
1003000300370000000034
1000030000070000000034
1000000003070000000001
1000300030000000000001
1002000000000000000001
1111111111111111111111