12 22
1111111111111111111111
1505498729480004900001
1500787629903403074621
1946047223625787004671
1200080020703057267621
1333332969807760774901
1736609354004668704291
1052027646202080006751
1200602070872802500641
1202282702027760743541
1589604603058206393271
1111111111111111111111
