12 22
1111111111111111111111
1894346852097506252941
1088590490947405862591
1023084560880907802661
1329522425990604426351
1423889636706440479031
1070945937970783800481
1575992269974600999661
1585005072566858939001
1756075067088029550851
1637044983739063325941
1111111111111111111111
