12 22
1111111111111111111111
1690750035575702440971
1445054005347625657001
1869020004506826650271
1242075602327960502661
1853983303800050733671
1376969700723004220791
1277360708647052229001
1445072388202728329221
1900054900402345700321
1059004905400063024641
1111111111111111111111
