12 22
1111111111111111441111
1000000000070000505001
1000030000070000030001
1003000500070000000001
1777777030070000030001
1000050003070003030001
1000000030030030030501
1000000000000702000701
1020000000500777777701
1000000000000003000001
1002000000030000300201
1111111111111111111111