12 22
1111111111111111111111
1970447450258893982541
1950584725685577598891
1887409057630843864071
1094487282853395027671
1974287924505200695751
1455465576338003476341
1835239802582250555231
1082299399724888939941
1007200702643500720001
1228559852949070740531
1111111111111111111111
